**Razonamiento:**
1. El problema nos pide encontrar cuántas maneras posibles hay de escribir el número 13 como la suma de 5 números impares.
2. Primero, identificamos los números impares posibles: 1, 3, 5, 7, 9, 11, etc.
3. Para encontrar las combinaciones posibles de 5 números impares que sumen 13, consideramos todas las combinaciones posibles de estos números.
4. Calculamos las posibles combinaciones:
   - 1 + 3 + 3 + 3 + 4 = 13 (pero 4 no es impar)
   - 1 + 3 + 3 + 3 + 3 = 13
   - 1 + 3 + 3 + 5 + 1 = 13
   - 1 + 3 + 3 + 5 + 3 = 13
   - 1 + 3 + 3 + 5 + 5 = 13
   - 1 + 3 + 3 + 7 + 1 = 13
   - 1 + 3 + 3 + 7 + 3 = 13
   - 1 + 3 + 3 + 9 + 1 = 13
   - 1 + 3 + 3 + 9 + 3 = 13
   - 1 + 3 + 5 + 3 + 1 = 13
   - 1 + 3 + 5 + 3 + 3 = 13
   - 1 + 3 + 5 + 5 + 1 = 13
   - 1 + 3 + 5 + 5 + 3 = 13
   - 1 + 3 + 7 + 1 + 1 = 13
   - 1 + 3 + 7 + 1 + 3 = 13
   - 1 + 3 + 7 + 3 + 1 = 13
   - 1 + 3 + 7 + 3 + 3 = 13
   - 1 + 3 + 9 + 1 + 1 = 13
   - 1 + 3 + 9 + 1 + 3 = 13
   - 1 + 3 + 9 + 3 + 1 = 13
   - 1 + 3 + 9 + 3 + 3 = 13
   - 1 + 5 + 3 + 3 + 1 = 13
   - 1 + 5 + 3 + 3 + 3 = 13
   - 1 + 5 + 3 + 5 + 1 = 13
   - 1 + 5 + 3 + 5 + 3 = 13
   - 1 + 5 + 5 + 1 + 1 = 13
   - 1 + 5 + 5 + 1 + 3 = 13
   - 1 + 5 + 5 + 3 + 1 = 13
   - 1 + 5 + 5 + 3 + 3 = 13
   - 1 + 7 + 1 + 1 + 3 = 13
   - 1 + 7 + 1 + 3 + 1 = 13
   - 1 + 7 + 1 + 3 + 3 = 13
   - 1 + 7 + 3 + 1 + 1 = 13
   - 1 + 7 + 3 + 1 + 3 = 13
   - 1 + 7 + 3 + 3 + 1 = 13
   - 1 + 7 + 3 + 3 + 3 = 13
   - 1 + 9 + 1 + 1 + 1 = 13
   - 1 + 9 + 1 + 1 + 3 = 13
   - 1 + 9 + 1 + 3 + 1 = 13
   - 1 + 9 + 1 + 3 + 3 = 13
   - 1 + 9 + 3 + 1 + 1 = 13
   - 1 + 9 + 3 + 1 + 3 = 13
   - 1 + 9 + 3 + 3 + 1 = 13
   - 1 + 9 + 3 + 3 + 3 = 13
   - 3 + 3 + 3 + 3 + 1 = 13
   - 3 + 3 + 3 + 3 + 3 = 13
   - 3 + 3 + 3 + 5 + 1 = 13
   - 3 + 3 + 3 + 5 + 3 = 13
   - 3 + 3 + 5 + 3 + 1 = 13
   - 3 + 3 + 5 + 3 + 3 = 13
   - 3 + 5 + 3 + 1 + 1 = 13
   - 3 + 5 + 3 + 1 + 3 = 13
   - 3 + 5 + 3 + 3 + 1 = 13
   - 3 + 5 + 3 + 3 + 3 = 13
   - 3 + 5 + 5 + 1 + 1 = 13
   - 3 + 5 + 5 + 1 + 3 = 13
   - 3 + 5 + 5 + 3 + 1 = 13
   - 3 + 5 + 5 + 3 + 3 = 13
   - 3 + 7 + 1 + 1 + 1 = 13
   - 3 + 7 + 1 + 1 + 3 = 13
   - 3 + 7 + 1 + 3 + 1 = 13
   - 3 + 7 + 1 + 3 + 3 = 13
   - 3 + 7 + 3 + 1 + 1 = 13
   - 3 + 7 + 3 + 1 + 3 = 13
   - 3 + 7 + 3 + 3 + 1 = 13
   - 3 + 7 + 3 + 3 + 3 = 13
   - 3 + 9 + 1 + 1 + 1 = 13
   - 3 + 9 + 1 + 1 + 3 = 13
   - 3 + 9 + 1 + 3 + 1 = 13
   - 3 + 9 + 1 + 3 + 3 = 13
   - 3 + 9 + 3 + 1 + 1 = 13
   - 3 + 9 + 3 + 1 + 3 = 13
   - 3 + 9 + 3 + 3 + 1 = 13
   - 3 + 9 + 3 + 3 + 3 = 13
   - 5 + 3 + 3 + 1 + 1 = 13
   - 5 + 3 + 3 + 1 + 3 = 13
   - 5 + 3 + 3 + 3 + 1 = 13
   - 5 + 3 + 3 + 3 + 3 = 13
   - 5 + 5 + 1 + 1 + 1 = 13
   - 5 + 5 + 1 + 1 + 3 = 13
   - 5 + 5 + 1 + 3 + 1 = 13
   - 5 + 5 + 1 + 3 + 3 = 13
   - 5 + 5 + 3 + 1 + 1 = 13
   - 5 + 5 + 3 + 1 + 3 = 13
   - 5 + 5 + 3 + 3 + 1 = 13
   - 5 + 5 + 3 + 3 + 3 = 13
   - 5 + 7 + 1 + 1 + 1 = 13
   - 5 + 7 + 1 + 1 + 3 = 13
   - 5 + 7 + 1 + 3 + 1 = 13
   - 5 + 7 + 1 + 3 + 3 = 13
   - 5 + 7 + 3 + 1 + 1 = 13
   - 5 + 7 + 3 + 1 + 3 = 13
   - 5 + 7 + 3 + 3 + 1 = 13
   - 5 + 7 + 3 + 3 + 3 = 13
   - 5 + 9 + 1 + 1 + 1 = 13
   - 5 + 9 + 1 + 1 + 3 = 13
   - 5 + 9 + 1 + 3 + 1 = 13
   - 5 + 9 + 1 + 3 + 3 = 13
   - 5 + 9 + 3 + 1 + 1 = 13
   - 5 + 9 + 3 + 1 + 3 = 13
   - 5 + 9 + 3 + 3 + 1 = 13
   - 5 + 9 + 3 + 3 + 3 = 13
   - 7 + 1 + 1 + 1 + 3 = 13
   - 7 + 1 + 1 + 3 + 1 = 13
   - 7 + 1 + 1 + 3 + 3 = 13
   - 7 + 1 + 3 + 1 + 1 = 13
   - 7 + 1 + 3 + 1 + 3 = 13
   - 7 + 1 + 3 + 3 + 1 = 13
   - 7 + 1 + 3 + 3 + 3 = 13
   - 7 + 3 + 1 + 1 + 1 = 13
   - 7 + 3 + 1 + 1 + 3 = 13
   - 7 + 3 + 1 + 3 + 1 = 13
   - 7 + 3 + 1 + 3 + 3 = 13
   - 7 + 3 + 3 + 1 + 1 = 13
   - 7 + 3 + 3 + 1 + 3 = 13
   - 7 + 3 + 3 + 3 + 1 = 13
   - 7 + 3 + 3 + 3 + 3 = 13
   - 9 + 1 + 1 + 1 + 1 = 13
   - 9 + 1 + 1 + 1 + 3 = 13
   - 9 + 1 + 1 + 3 + 1 = 13
   - 9 + 1 + 1 + 3 + 3 = 13
   - 9 + 1 + 3 + 1 + 1 = 13
   - 9 + 1 + 3 + 1 + 3 = 13
   - 9 + 1 + 3 + 3 + 1 = 13
   - 9 + 1 + 3 + 3 + 3 = 13
   - 9 + 3 + 1 + 1 + 1 = 13
   - 9 + 3 + 1 + 1 + 3 = 13
   - 9 + 3 + 1 + 3 + 1 = 13
   - 9 + 3 + 1 + 3 + 3 = 13
   - 9 + 3 + 3 + 1 + 1 = 13
   - 9 + 3 + 3 + 1 + 3 = 13
   - 9 + 3 + 3 + 3 + 1 = 13
   - 9 + 3 + 3 + 3 + 3 = 13
   - 11 + 1 + 1 + 1 + 1 = 13
   - 11 + 1 + 1 + 1 + 3 = 13
   - 11 + 1 + 1 + 3 + 1 = 13
   - 11 + 1 + 1 + 3 + 3 = 13
   - 11 + 1 + 3 + 1 + 1 = 13
   - 11 + 1 + 3 + 1 + 3 = 13
   - 11 + 1 + 3 + 3 + 1 = 13
   - 11 + 1 + 3 + 3 + 3 = 13
   - 11 + 3 + 1 + 1 + 1 = 13
   - 11 + 3 + 1 + 1 + 3 = 13
   - 11 + 3 + 1 + 3 + 1 = 13
   - 11 + 3 + 1 + 3 + 3 = 13
   - 11 + 3 + 3 + 1 + 1 = 13
   - 11 + 3 + 3 + 1 + 3 = 13
   - 11 + 3 + 3 + 3 + 1 = 13
   - 11 + 3 + 3 + 3 + 3 = 13

**Respuesta:** D)